####################
#..................#
#..................#
#####.####.........#
#........#.........#
#........#.........#
####################